20 20
3 0 0 0 0 0 0 0 0 1 2 0 0 0 0 0 0 1 0 0 
0 0 0 0 0 0 0 0 0 0 0 0 1 1 1 0 0 1 1 0 
0 0 0 0 0 0 0 0 0 0 1 0 1 0 1 0 0 1 0 0 
1 0 1 0 1 0 0 0 0 0 1 1 1 0 1 0 1 1 0 1 
0 0 1 0 1 0 0 0 1 1 1 0 0 0 1 0 0 0 0 0 
0 1 1 0 1 0 0 0 0 0 0 0 0 0 1 1 1 1 1 0 
0 1 0 0 1 0 0 0 0 1 1 1 0 0 0 0 1 0 0 0 
0 1 0 0 1 0 0 0 0 1 1 0 0 1 0 0 1 0 0 0 
0 0 0 0 1 0 1 0 0 0 1 0 1 1 1 1 1 0 1 1 
0 0 0 0 1 1 1 1 1 0 1 0 1 0 0 0 1 0 1 0 
0 0 0 0 0 0 0 0 1 0 1 0 1 0 1 0 1 0 1 0 
0 0 1 0 0 0 1 1 1 1 1 0 1 0 1 1 1 0 1 0 
1 0 1 0 1 0 1 0 0 1 0 0 1 0 0 0 0 0 0 0 
0 0 0 1 0 0 1 1 0 1 0 1 1 1 1 1 1 0 1 1 
0 1 1 1 0 1 1 0 0 0 0 0 0 0 1 0 1 0 1 0 
0 0 0 1 0 0 1 1 1 0 0 0 1 0 0 0 1 0 1 0 
1 1 0 1 1 0 0 1 0 0 0 0 1 1 1 1 1 0 1 0 
0 0 0 0 1 1 0 0 0 0 0 0 1 0 0 0 0 0 1 0 
0 0 0 0 1 1 1 1 0 0 0 0 1 1 1 1 1 1 1 0 
0 0 0 0 0 0 0 0 0 0 0 0 0 0 0 0 0 0 0 0 
1 6 1 6
2 8 2 8
3 6 6 6
6 7 6 7
9 1 9 2
11 3 12 3
16 10 19 10
18 1 18 2
