10 10
3 0 0 0 0 0 0 0 0 0 
0 0 0 0 0 0 0 0 0 0 
0 0 0 0 0 0 0 0 0 0 
1 1 0 0 0 0 0 0 1 1 
2 0 0 0 0 0 0 0 0 2 
1 1 0 0 0 0 0 0 1 1 
0 0 0 0 0 0 0 0 0 0 
0 0 0 0 0 0 0 0 0 0 
0 1 0 1 0 0 0 0 0 0 
0 1 2 1 0 0 0 0 0 0 
2 2 5 2
2 7 5 7
7 1 7 4
