5
10
0 0 0 0 0 0 0 0 0 0 
4 0 4 1 1 1 1 1 1 1 
4 2 0 0 0 0 0 0 3 1 
4 0 4 1 1 1 1 1 1 1 
0 0 0 0 0 0 0 0 0 0 
